1111111111111111111111111111111111
1E0000000000000C0X000C00000X000001
1010010100100000101001000000010101
1010010010101010001001000000010101
100000XX0C00C000000P0000X0000000C1
1111111111110000000111111111111111
1000000000000000000000000000000001
1E0000000000000C0X000C00000X000001
1010010100100000101001000000010101
1010010010101010001001000000010101
100000XX0C00C000000P0000X0000000C1
1111111111111111111111111111111111