1111111111111111111
100000000000000C0X1
1010010100100000101
1010010010101010001
100000XX0C00C000001
1110001111110000001
1000000000000000001
1E1000000000000C0X1
1110010100100000101
1010010010101010001
100000XX0CP0C000001
1111111111111111111