1111111111111
1X01000000C11
1001000000C11
1000011111001
1P0011E000001
1111111111111