1111111111111111111
10001000X0000X00101
1110001100100100001
1E0000000010000C0X1
1110010000100000101
1010010110101010001
100000XX0CP0C000011
1111111111111111111