1111111111111
1PCCCCCCCCCC1
1CCCCCCCCCCC1
1CCCCCCCCCCC1
1CCCCCCCCCCC1
1CCCCCCCCCCE1
1111111111111