1111111111111
1CCCCCCCCCCC1
1PCCCCCCCCCC1
1CCCCCECCCCC1
1CCCCCCCCCCC1
1CCCCCCCCCCC1
1111111111111