1111111111111
1PCCCCCCCCC01
1CCCCCCCCCCC1
1CCCCCCCCCCC1
1CCCCCCCCCCC1
1XCCCCCCCCCE1
1111111111111