1111111
1EC00P1
1000001
10000X1
1111111