1111111
10000P1
10000X1
1CE0001
1111111