1111111
1E000P1
10000010
1C000X1
1111111