1111111
1E00001
1000011
1C000X1
1111111