1111111
1E000P1
1000001
1C000X1
1111111