11111111111111111111111
1E00X0000000X00C00000C1
10100101001000001010011
10100100101010100010011
1P0000000C00C000000X0C1
11111111111111111111111