1111111111111111111
10000000C0000001111
1000111111000001111
10000X00C0000P01111
10X0100000000E01111
10C01111101100000C1
1111111111111111111