11111111
1CCCCCC1
1PCCCCC1
1ECCCCC1
11111111