1111111111111
100100C0000C1
1C010111110X1
1P0111E000001
1111111111111